............
.||||||||||.
.|........|.
.||||||||||.
............