||||||||||||||||||||||||||||||||||||||||
|,,,,,,,|||,,,,,,,,|,,,,,,,|,,,,,,,,,,,|
|,,|||,,|||,,,,,,,,|,,,,,,,|,,,||||,||||
||,|,,,,,,,,,,,,,,,,,,,,,,,|,,,|,,,,,,,|
||,|,,,,||,,,,,,,,,|,,,,,,,|,,,|,,,,,,,|
|,,|,,,,||,,,,,,,,,|,,,,,,,|,,,|,,,,,,,|
|,,|||,|||||||,|||||||||||||,,,|,,,,,,,|
|,,,,,,,,,,,,,,|,,,,,|,,,,,|,,,|,,,,,,,|
|,,|||||||,,,,,|,,,,,|,,,,,|,,,|,,,,,,,|
||,|,,,,,|,,,,,|,,,,,|,,,,,|,,,|,,,,,,,|
||,|,,,,,|,,,,,|||,|||,,,,,|,,,|,,,,,,,|
||,|,,,,,|,,,,,|,,,,,|,,,,,|,,,||||,||||
||,|,,,,,|,,,,,|,,,,,,,,,,,|,,,|,,,,,,,|
||,|,,,,,|,,,,,|,,,,,|,,,,,|,,,|,,,,,,,|
||,,,,,,,|,,,,,|,,,,,|,,,,,|,,,|,,,,,,,|
||,||,,,,|,,,,,,,,,,,|,,,,,,,,,|,,,,,,,|
|,,,|,,,,|,,,,,|,,,,,|,,,,,,,,,|,,,,,,,|
|,,,|,,,,|,,,,,|,,,,,|,,,,,|,,,|,,,,,,,|
|,,,|,,,,,,,,,,|,,,,,|,,,,,|,,,|,,,,,,,|
||||||||||||||||||||||||||||||||||||||||