............
.||||||||||.
.|,,,,,,,,|.
.||||,,||||.
....|,,|....
.||||,,||||.
.|,,,,,,,,|.
.||||||||||.
............